1111111
10ECP11
1111111
1111111
